s00000120b240-70
p00000200n260-70
s00000320b240-70
s00000320z120-70
s00000320z360-70
s00000660z240-70
s00000660z120-70
s00000660z360-70
s00000680z240-70
s00000680z120-70
s00000680z360-70
s00000700z240-70
s00000700z120-70
s00000700z360-70
s00000720z240-70
s00000720z120-70
s00000720z360-70
s00001320b240-70
s00001330b120-70
s00001340b360-70
p00001400n100-70
s00002060z100-70
s00002060z150-70
s00002060z200-70
s00002060z250-70
s00002060z300-70
s00002060z350-70
s00002060z400-70
s00002360z100-70
s00002360z150-70
s00002360z200-70
s00002360z250-70
s00002360z300-70
s00002360z350-70
s00002360z400-70
p00002399n260-70
p00002420n260-70
s00002550b400-70
s00002600b100-70
s00002650b400-70
s00002750b400-70
s00002800b100-70
s00002850b400-70
s00003000b200-70
s00003300b245-70
s00003300b380-70
s00003345b200-70
s00003345b290-70
s00003345b380-70
s00003390b200-70
s00003390b335-70
s00003390b380-70
s00003435b200-70
s00003435b380-70