s00000120b240070
p00000200n260070
s00000320b240070
s00000320z120070
s00000320z360070
s00000660z240070
s00000660z120070
s00000660z360070
s00000680z240070
s00000680z120070
s00000680z360070
s00000700z240070
s00000700z120070
s00000700z360070
s00000720z240070
s00000720z120070
s00000720z360070
s00001320b240070
s00001330b120070
s00001340b360070
p00001400n100070
s00002060z100070
s00002060z150070
s00002060z200070
s00002060z250070
s00002060z300070
s00002060z350070
s00002060z400070
s00002360z100070
s00002360z150070
s00002360z200070
s00002360z250070
s00002360z300070
s00002360z350070
s00002360z400070
p00002399n260070
p00002420n260070
s00002550b400070
s00002600b100070
s00002650b400070
s00002750b400070
s00002800b100070
s00002850b400070
s00003000b200070
s00003300b245070
s00003300b380070
s00003345b200070
s00003345b290070
s00003345b380070
s00003390b200070
s00003390b335070
s00003390b380070
s00003435b200070
s00003435b380070
s00004000M100100